adenoidal (adj)	sounding as if the nose were pinched
rapacious (adj)	aggressively greedy or grasping
effigy (n)	a sculpture or model of a person; a crude model of a person made in order to be damaged or destroyed
pertinacious (adj)	holding firmly to an opinion or course of action
physiognomy (n)	facial features, especially when regarded as revealing character or ethnic origin
copula (n)	a connecting word, in particular a form of the verb be connecting a subject and complement
stochastic (adj)	randomly determined; having a random probability distribution or pattern that may be analyzed statistically but may not be predicted precisely
perfidious (adj)	deceitful and untrustworthy
absquatulate (v)	leave abruptly
precariat (n)	a neologism that combines precariousness with the proletariat to describe workers employed in part-time, insecure jobs with low wages and no control over their work hours/conditions
pseudepigraphy (n)	the ascription of false names of authors to works
sonorous (adj)	imposingly deep and full; capable of producing a deep or ringing sound; using imposing language
dilettante (n)	a person who cultivates an area of interest without real commitment or knowledge
parochial (adj)	relating to a church parish; having a limited or narrow outlook
edify (v)	instruct or improve someone morally or intellectually
erudite (adj)	learned; scholarly
vituperative (adj)	bitter and abusive
recalcitrant (adj)	having an obstinately uncooperative attitude toward authority or discipline
galvanic (adj)	relating to, or producing a direct current of electricity; sudden and dramatic
ampersand (n)	the character &
sinuous (adj)	having many curves; lithe and supple
proleptic (adj)	anticipatory, pre-supposed, preceding an argument as to anticipate and preclude the outcome
recidivist (n)	a convicted criminal who reoffends, especially repeatedly
axiom (n)	a statement or proposition which is regarded as being established, accepted, or self-evidently true
sepulchral (adj)	relating to a tomb or interment; gloomy, dismal
avaricious (adj)	having or showing an extreme greed for wealth or material gain
sibilant (adj)	making or characterized by a hissing sound
tractable (adj)	easy to control or influence or deal with
pleonasm (n)	the use of more words than are necessary to convey meaning (e.g. see with one's eyes)
hirsute (adj)	hairy
concupiscence (n)	strong sexual desire; lust
tumescent (adj)	swollen or becoming swollen, especially as a response to sexual arousal; pompous or pretentious (especially of language or literary style)
bloviate (v)	talk at length, especially in an inflated or empty way
turgent (adj)	swollen
voluptuary (n)	a person devoted to luxury and sensual pleasure
batrachian (adj)	of a frog or toad
desipience (n)	relaxed dallying in enjoyment of foolish trifles; silliness
expurgate (v)	censor
venal (adj)	corrupt; can be bribed
venery (n)	sexual indulgence
vitiate (v)	spoil or impair the quality or efficiency of
viscid (adj)	glutinous; sticky
mephitic (adj)	foul-smelling
lugubrious (adj)	mournful; gloomy
putrescence (adj)	rotten, decaying matter; becoming putrid
algedonic (adj)	pertaining to both pleasure and pain
refulgent (adj)	shining brightly
polysemantic (adj)	having many meanings
a priori (adj)	deduced from theory rather than from observation or experience
impudent (adj)	not showing due respect for another person; impertinent
catechism (n)	a summary of the principles of Christian religion in the form of questions and answers, used for the instruction of Christians; a series of fixed questions, answers, or precepts used for instruction in other situations
perfidy (n)	deceitfulness; untrustworthiness
punctilious (adj)	showing great attention to detail or correct behavior
exiguous (adj)	very small in size or amount
peripeteia (n)	a sudden reveal of fortune or change in circumstances
apothegm (n)	a concise saying or maxim; an aphorism
contrition (n)	the state of feeling remorseful and penitent
laconic (adj)	using very few words
gnomic (adj)	expressed in or of the nature of short, pithy maxims or aphorisms; enigmatic, ambiguous
cant (n)	hypocritical and sanctimonious talk, typically of a moral religious or political nature; slang, jargon of a certain group
penitential (adj)	relating to or expressing penitence or penance
impertinence (n)	lack of respect, rudeness
inure (v)	accustom someone to something, especially something unpleasant
inculcate (v)	to impress on the mind by repetition, teach persistently and earnestly
inoculate (v)	to protect against disease, error, or harm
sacerdotal (adj)	relating to priests or the priesthood; priestly
recrudescence (n)	the recurrence of an undesirable condition
superlative (adj)	of the highest quality or degree
outr√© (adj)	unusual and startling
chimera (n)	a thing that is wished for but in fact is illusory or impossible to achieve
paroxysm (n)	a sudden attack or violent expression of a particular emotion or activity
febrile (adj)	feverish
sentinel (n)	a guard; sentry
stratify (v)	arrange or classify
pugilistic (adj)	looking for a fight; relating to fighting with the fists
antimony (n)	a contradiction between two beliefs or conclusions that are in themselves reasonable; a paradox
attenuate (v/adj)	reduce the force, effect, or value of; thin or reduced in thickness
deleterious (adj)	causing harm or damage
exegesis (n)	critical explanation or interpretation of a text
auspice (n)	a divine or prophetic token
logorrhea (n)	pathologically excessive and often incoherent talkativeness
dysphemism (n)	a derogatory or negative epithet; ex "loony bin" for mental hospital
bacchanalian (adj)	characterized by drunken revelry; riotously drunken
patrician (adj)	belonging to or characteristic of the aristocracy or nobility
redux (adj)	brought back; revived
extemporize (v)	compose, perform, or produce something without preparation; improvise
atavism (n)	a tendency to revert to something ancient or ancestral
atavistic (adj)	characteristic of a former era, ancient
avarice (n)	extreme greed for wealth or material gain
garrulous (adj)	excessively talkative, especially on trivial matters
truculent (adj)	eager or quick to fight; aggressively defiant
gestalt (n)	an organized whole that is perceived as more than the sum of its parts
etiology (n)	the cause of a disease or condition
uxorious (adj)	having or showing an excessive or submissive fondness for one's wife
meretricious (adj)	apparently attractive but having in reality no value or integrity
aver (v)	to affirm, declare confidently
quixotic (adj)	exceedingly idealistic; unrealistic and impractical
indigent (adj)	poor
insolvent (adj)	bankrupt; unable to pay debts
epistolary (adj)	in the form of letters
abeyance (n)	a state of temporary disuse or suspension
salubrious (adj)	healthy or promoting good health
augury (n)	a sign of what will happen in the future; an omen
ebullient (adj)	cheerful and full of energy
epistemic (adj)	of or relating to knowledge or knowing
syncretism (n)	the amalgamation of different religions, cultures, or schools of thought
metonymy (n)	substituting the name of one object for another object closely associated with it; ex: "suit" for business exec
erotomania (n)	a disorder involving the fixed (but incorrect) belief that one is loved by another (usually higher class/unattainable), which persists in the face of strong evidence to the contrary
neurasthenia	lack of nerve strength; nervous exhaustion and weakness chiefly associated with emotional disturbance
apostasy (n)	the denial of god and the repudiation of faith
syllogism (n)	a form of reasoning in which a conclusion is drawn from two given/assumed premises, each of which shares a term with the conclusion, and shares a common term not present in the conclusion; ex: all dogs are animals, all animals have 4 legs, therefore all dogs have 4 legs
spurious (adj)	forged; not genuine although outwardly similar or having some correspondence
consummate (v/adj)	to make complete by having sex; showing a high degree of skill and flair, perfect or complete
equanimity (n)	mental calmness and composure especially in difficult situations
apotheosis (n)	the highest point in the development of something; culmination or climax
imperious (adj)	assuming power or authority without justification; arrogant and domineering
replete (adj)	fully or abundantly filled or supplied
redolent (adj)	strongly reminiscent of; having a sweet or pleasant odor
positivism (n)	the belief that knowledge should be derived from scientific observation; rejects metaphysics and theism
subjectivism (n)	the doctrine that knowledge is merely subjective and that there is no external or objective truth
empiricism (n)	the theory that all knowledge is derived from sense-experience; all concepts originate in experience
subcutaneous (adj)	situated or applied under the skin
jouissance (n)	physical or intellectual pleasure; lacan's theory that enjoyment/pleasure go beyond mere satisfaction of an instinct
sartorial (adj)	relating to tailoring, clothes, or style of dress
simian (adj)	relating to or resembling an ape
bardic (adj)	lyrical, poetic
ontology (n)	the branch of metaphysics dealing with the nature of being.
epistemology (n)	the theory of knowledge, especially with regard to its methods, validity, and scope; the investigation of what distinguishes justified belief from opinion
deontology (n)	an ethical theory that focuses on rules and principles as binding ethical obligations to act in a certain way
parlous (adj)	full of danger or uncertainty; precarious
epicurean (adj)	devoted to the pursuit of pleasure; fond of good food, comfort, and ease; with discriminating tastes; a person with discriminating tastes
eschatology (n)	theology concerned w/ death, judgment, and the final destiny of humankind
mephistophelian (adj)	wicked; fiendish
intractable (adj)	hard to control or deal with; difficult or stubborn
onanistic (adj)	of or pertaining to masturbation; serving only for intellectual or emotional self-gratification, unproductive
albumen (n)	the white of an egg
vitelline (adj)	pertaining to the yolk of eggs or an embryo's yolk
itinerant (adj)	traveling from place to place
teleology (n)	the explanation of phenomena by the purpose they serve rather than by postulated causes
dalliance (n)	a casual romantic or sexual relationship
bathetic (adj)	producing an unintentional effect of anticlimax; anticlimactic, disappointing
bathos (n)	an effect of anticlimax created by an unintentional lapse in mood from the sublime to the trite; insincere/overdone pathos; exceptional commonplaceness
shambolic (adj)	obviously disorganized or confused
dilatory (adj)	tending or intended to cause delay; characterized by procrastination
b√™te noire	someone or something that is feared or disliked
loquacity	talkativeness
eidetic	pertaining to extraordinarily detailed and vivid recall/memory especially of vivid images
puerile (adj)	juvenile, childish, silly
pantheon (n)	a group of people held in high esteem for their great achievements
dolorous (adj)	expressing/caused by/marked by misery or grief
ancillary (adj)	subordinate or supplementary; providing necessary support to the primary activities or an organization
auxiliary (adj)	providing supplementary help and support
tawdry (adj)	showy and flashy but lacking in good taste
phlegmatic (adj)	slow-moving, sluggish; unemotional
lambent (adj)	softly bright or radiant; moving lightly over a surface; flickering; marked by lightness or brilliance
extant (adj)	currently existing, not destroyed/lost
interim (n)	an intervening time; interval
sojourn (n, v)	a temporary stay; to stay for a time
debility (n)	weakness, frailty
indolence (adj)	inclination to laziness; sloth
insolent (adj)	insultingly contemptuous in speech or conduct
ecumenical (adj)	worldwide or universal in influence or application
derision (n)	the use of ridicule or scorn to show contempt
derisory (adj)	ridiculously small or inadequate; another word for derisive, mocking, ridiculing
inure (v)	to harden; accustom; become used to
extol (v)	to praise highly
desultory (adj)	marked by lack of definite plan; not connected in main subject; disappointing in progress, performance, or quality
lassitude (n)	a condition of weariness or debility; a condition characterized by lack of interest, energy, or spirit; languor
pique (v)	to excite or arouse especially by a provocation or challenge
pugnacious (adj)	having a quarrelsome or combative nature
diffidence (n)	shyness; lack of confidence
rectitude (n)	moral uprightness; righteousness; the quality of being correct in judgment or procedure
evanesce (v)	to dissipate like vapor
exculpatory (adj)	tending or serving to exculpate
exculpate (v)	to clear from alleged fault or guilt
capacious (n)	spacious, roomy
peripatetic (adj)	traveling from place to place, in particular working or based in various places for relatively short periods
argot (n)	the language used by a particular group of people, an often secret vocabulary and idiom peculiar to a particular group
fulcrum (n)	a thing that plays a central/essential role in an activity/situation; the point on which a lever pivots
abnegate (v)	renounce or reject (something desired or valuable)
tautology (n)	needless repetition of an idea by using different but equivalent words; a redundancy
languor (n)	the state or feeling, often pleasant, of tiredness or inertia; an oppressive stillness of the air
anhedonia (n)	inability to experience pleasure
paroxysm (n)	a sudden outburst; a fit of a particular emotion or activity
abjure (v)	solemnly renounce (a belief, cause, or claim)
auspice (n)	a divine or prophetic token
chimera (n)	a thing that is hoped or wished for but in fact is illusory or impossible to achieve
enwomb (v)	to enclose in or as if in a womb
pestilential (adj)	relating to or tending to cause infectious diseases
Immutable (adj)	unchangeable
garrulous (adj)	given to much talking, tediously chatty
collate (v)	to arrange into the proper order, especially documents
omnibus (n)	
hermeneutics (n)	the branch of knowledge that deals with interpretation, especially of the Bible or literary texts.
isomorphism (n)	a constraining process that forces one unit in a population to resemble other units that face the same set of environmental conditions
encomium (n)	a formal expression of praise, a lavish tribute
synecdochic (adj)	using the name of a part for that of the whole or the whole for the part; or the special for the general or the general for the special; or the material for the thing made of it; "to use `hand' for `worker'
asymptotic (adj)	refers to tails of distributions that approach the baseline but never touch the baseline
substratum (n)	an underlying layer or substance, in particular, a layer of rock or soil beneath the surface of the ground; a foundation or basis of something
numinous (adj)	having a strong religious or spiritual quality; indicating or suggesting the presence of a divinity
autarchy (n)	rule by an absolute sovereign
interpolation (n)	the insertion of something of a different nature into something else
usury (n)	the illegal action of lending money at unreasonably high rates of interest.
indicia (n)	signs, indications, or distinguishing marks
putative (adj)	generally considered or reputed to be
tenement (n)	a room or set of rooms forming a separate residence within a house or block of apartments; a piece of land held by an owner
apperception (n)	the act of interpreting the environment and perceiving the meaning of what is going on in a situation; fully conscious perception
ablution (n)	the act of washing oneself (often used for humorously formal effect)
sybaritic (adj)	fond or sensuous luxury or pleasure; self-indulgent
internecine (adj)	destructive to both sides in a conflict; relating to conflict within a group or organization
sangfroid (n)	composure or coolness, especially in trying circumstances
plutocrat (n)	a person whose power derives from their wealth; tycoon or rich person
oneiric (adj)	relating to dreams or dreaming
egregore (n)	a non-physical entity that arises from the collective thoughts of a distinctive group of people
antediluvian (adj)	of or belonging to the time before the biblical flood
gadfly (n)	an annoying person, especially one who provokes others into action by criticism
eo ipso (adv)	by that very act or quality; thereby
heterodox (adj)	not in agreement with accepted beliefs; holding unorthodox opinions
hidebound (adj)	unwilling or unable to change because of tradition or convention
opine (adj)	hold and state as one's opinion
sectarian (adj)	denoting or concerning a sect or sects
intercession (n)	the action of intervening on behalf of another; the action of saying a prayer on behalf of another
crucible (n)	a situation of severe trial leading to the creation of something new
bacchanal (n)	an occasion of wild or drunken revelry
ineluctable (adj)	unable to be resisted or avoided; inescapable
psychometrics (n)	the science of measuring mental capacities and processes; generally refers to specialized fields within psychology and education devoted to testing, measurement, assessment, etc
lede (n)	the opening sentence or paragraph of a news article
bon vivant (n)	a person who enjoys a luxurious and sociable lifestyle
occlude (v)	stop, close up, or obstruct, hide or obscure from prominence or view
revanchism (n)	a policy of seeking to retaliate, especially to recover lost territory
synecdoche (n)	a figure of speech in which a part is made to represent the whole or vice versa (ex: "Cleveland won" to say "Cleveland's baseball team")
preclude (v)	to make impossible by necessary consequence; rule out in advance
badinage (n)	humorous or witty conversation
mellifluous (adj)	sweet or musical; pleasant to hear
zaftig (adj)	having a full, rounded figure; plump
glabrous (adj)	free from hair or down; smooth
pulchritude (n)	beauty
nugatory (adj)	of no value or importance; useless or futile
peripatetic (n/adj)	a person who travels from place to place (n)/traveling from place to place, in particular working or based in relatively short periods (adj)
redound (v)	contribute greatly to (a person's credit or honor)
coriaceous (adj)	resembling or having the texture of leather
adumbrate (v)	report or represent in outline; indicate faintly; foreshadow or symbolize
rictus (n)	a fixed grimace or grin
pullulate (v)	multiply or spread prolifically or rapidly; be full of or teeming with
eldritch (adj)	weird and sinister or ghostly
soup√ßon (n)	a very small quantity of something
ineluctable (adj)	unable to be resisted or avoided; inescapable
verdigris (n)	a bright bluish-green encrustation or patina formed on copper or brass by atmospheric oxidation, consisting of basic copper carbonate
minatory (adj)	expressing or conveying a threat
adipose (adj)	(especially of body tissue) used for the storage of fat
oblatory (adj)	the act of offering something, such as worship or thanks, to a deity
remonstrance (n)	a forcefully reproachful protest
adamantine (adj)	unbreakable
suborn (v)	bribe or otherwise induce (someone) to commit an unlawful act such as perjury
harridan (n)	a strict, bossy, or belligerent old woman
occiput (n)	back part of the skull
sophistry (n)	a deliberately deceptive or misleading argument
contretemps (n)	an inopportune or embarrassing occurrence; a mishap
hew (v)	to shape or cut down with an ax
aperture (n)	an opening or hole
depilate (v)	to remove hair from
intransigence (n)	refusal of any compromise; stubbornness
juggernaut (n)	a huge, powerful, and overwhelming force or institution
etiolated (adj)	pale and drawn out due to lack of light (of a plant)
refectory (n)	a room used for communal meals, especially in an educational or religious institution
mendacity (n)	untruthfulness; dishonesty
extirpate (v)	to tear up by the roots; to destroy totally
tenebrous (adj)	dark and gloomy
matutinal (adj)	relating to or occurring in the morning.
lacustrine (adj)	pertaining to lakes
arid (adj)	extremely dry
apostate (n)	a person who renounces a religious or political belief or principle
obstreperous (adj)	noisy and difficult to control
infidel (n)	a person who does not believe in religion or who adheres to a religion other than one's own
vitreous (adj)	like glass in appearance or physical properties
couchant (adj)	(of an animal) lying with the body resting on the legs and the head raised
dorsal (adj)	of, on, or relating to the back
prognostication (n)	the action of foretelling or prophesying future events
iniquity (n)	immoral or grossly unfair behavior
Arcadian (adj)	relating to or constituting an ideal rural paradise (relating to Arcadia in Greece)
talismanic (adj)	relating to or of the nature of a talisman
sericulture (n)	The production of silk and the rearing of silkworms for this purpose
pecuniary (adj)	relating to or consisting of money
occultation (n)	an event that happens when one object passes in front of another from an observer's perspective
seminarian (n)	a student who is studying at a seminary or college in order to become a priest, rabbi, or minister
deus ex machina (n)	an unexpected power or event saving a seemingly hopeless situation, especially as a contrived plot device in a play or novel.
arcana (n)	secrets or mysteries
homunculus (n)	a very small human or humanoid creature
lenticular (adj)	shaped like a lentil; relating to the lens of the eye
idiot savant (n)	a person who has an exceptional aptitude in one particular field, such as music or mathematics, despite having significant impairment in other areas of intellectual or social functioning
presbyopia (n)	impaired vision as a result of aging
tutelage (n)	instruction; tuition
aeolian (adj)	relating to or arising from the action of the wind
expatiate (v)	to speak or write at great length
prestidigitation (n)	magic tricks; sleight of hand
arboreal (adj)	living in trees
crenellated (adj)	(of a building) having turrets and battlements in the style of a castle
peremptory (adj)	(especially of a person's manner or actions) insisting on immediate attention or obedience, especially in a brusquely imperious way
harry (v)	persistently carry out attacks on (an enemy or an enemy's territory).
auscultation (n)	listening with stethoscope or other instrument to the sounds of the body
pate (n)	a person's head
inguinal (adj)	of the groin
determinism (n)	the doctrine that all events, including human action, are ultimately determined by causes external to the will
phylum (n)	in taxonomy, a group below kingdom and above classes
stratum (n)	layer; a level or class to which people are assigned according to their social status, education, or income
remunerate (v)	pay someone for services
fetor (n)	a strong, foul smell
in fragrante delicto (adv)	in the very act of wrongdoing, especially in an act of sexual misconduct; "caught red handed"
menarche (n)	the first menstrual period
epiphenomenon (n)	a secondary effect or byproduct that arises from but does not causally influence a process; EX: "having an increased risk of breast cancer concurrent with taking an antibiotic is an epiphenomenon. It is not the antibiotic that is causing the increased risk, but the increased inflammation associated with the bacterial infection that prompted the taking of an antibiotic."
bowdlerize (v)	remove "offensive" material from a text, especially with the result that the text becomes weaker or less effective
pudendum (n)	a person's external genitals, especially a woman's
sibylline (adj)	prophetic; oracular
dimorphic (adj)	occurring in two distinct forms; EX: sexual dimorphism in animals means the woman may have a different size or color than the male
transmogrify (v)	to change or alter greatly and often with grotesque or humorous effect
palimpsest (n)	a manuscript or piece of writing material on which the original writing has been effaced to make room for later writing but of which traces remain
diurnal (adj)	of or during the day; daily
pessary (n)	an object placed in the vagina to treat infection or as a contraceptive
perdition (n)	damnation; ruin; hell
prognosis (n)	the likely course of a disease or ailment
diurnal (adj)	active during the day
dipterous (adj)	having 2 wings
suppurate (v)	undergo the formation of pus; fester
parricide (n)	the killing of a parent or other near relative
cordilleras (n)	a group of parallel mountain ranges with shared features like plateaus, particularly in the Andes and the Rockies
purlieu (n)	the area near or surrounding a place
adduce (adj)	cite as evidence
fructify (adj)	make something more productive
cogitation (n)	the action of thinking deeply about something; contemplation
lacuna (n)	an unfilled space or interval; a gap
august (adj)	marked by majestic dignity or grandeur
crepuscular (adj)	of, resembling, or relating to twilight
seraglio (n)	the palace of a sultan
naiad (n)	in classic mythology, a nymph known to inhabit water
susurration (n)	a whispering sound; a murmur
anomie (n)	social instability resulting from a breakdown of standards and values; personal unrest, alienation, and uncertainty that comes from a lack of purpose or ideals
abrogate (adj)	to abolish by authoritative action; annul; to treat as nonexistent; to fail to do what is required
alluvial (adj)	deposited by a stream
abstemious (adj)	not self-indulgent, especially when eating and drinking
lachrymose (adj)	tearful; sad
transmogrify (v)	transform in a surprising or magical manner
shibboleth (n)	a word, expression, or custom that distinguishes a particular group of persons from all others; a commonplace saying or truism
pareidolia (n)	tendency to perceive meaningful images in meaningless visual stimuli
dipsomaniac (adj)	person with an uncontrollable craving for alcohol
monograph (n)	a scholarly report on one subject
desideratum (n)	something needed and wanted
substrate (n)	the base on which organism lives
otiose (adj)	easily flexed
interstice (n)	a space that intervenes between things
foment (v)	to promote the growth or development of
sibilant (adj)	having, containing, or producing the sound of a sound resembling that of the s or the sh in sash
eldritch (adj)	strange or unnatural especially in a way that inspires fear: weird, eerie
priapic	relating to a phallus; relating to male sexuality
lissome	easily flexed
debride (v)	remove damaged tissue or foreign objects from (a wound)
mellifluous (adj)	sweetly flowing or sounding
argot (n)	special words or phrases used by a specific group of people
ambrosial (adj)	exceptionally pleasing to taste or smell; extremely delicious; excellent
Cimmerian (adj)	dark and gloomy; relating to or characteristic of the mythical Cimmerians or the perpetual mist and darkness in which they lived
suppurate (adj)	undergo the formation of pus; fester
paripatetic (adj)	walking or traveling about
impecunious (adj)	having little or no money
prevarication (n)	the use of ambiguous or evasive language or behavior to conceal the truth or avoid committing oneself
nephalist (n)	a person who does not drink alcohol
Calvinistic (adj)	related to a form of Christianity that emphasizes God's power, humanity's sinfulness, and predestination
lucre (n)	money, especially when regarded as sordid or distasteful or gained in a dishonorable way
ataxia (n)	lack of muscle coordination during voluntary movement
comport (v)	to conduct or bear oneself, behave; to be in agreement
imbroglio (n)	a difficult and embarrassing situation
adamantine (adj)	unbreakable
hoarfrost (n)	white frost, frozen dew on the ground
nota bene (v)	note well; take notice
conciliate (v)	to reconcile, to pacify, to renew a friendship
fait accompli (n)	an accomplished and presumably irreversible deed, fact, or action
nickelodeon (n)	a jukebox or movie theater, originally with the insertion of a nickel coin
arrogate (v)	to take or claim without justification
invidious (adj)	offensive, hateful; tending to cause bitterness and resentment
plangent (adj)	[of a sound] loud, reverberating, and often melancholy
lacuna (n)	an unfilled space or interval; a gap
affflatus (n)	a divine imparting of knowledge or power
word: presage
class: verb
definition: (of an event) be a sign or warning that (something, typically something bad) will happen